11111111111111
100P0000000001
10000000000001
10000000000001
10000000000001
100000000000E1
11111111111111