11111111111111
100P0000000001
10000000000001
10000000000001
100000000000C1
10000000000001
11111111111111