111111111111111111111111111111
1P000000000C000000000E00000001
100111111111111111110000000001
10000000C000000000000000000001
101111111111111111111100000001
1000000000C0000000000000000001
101111111111111111111100000001
10C00000000000000C000000000001
100111111111111111110000000001
100000000C000000000C0000000001
100000000C000000000C0000000001
100000000C000000000C0000000001
100000000C000000000C0000000001
100000000C000000000C0000000001
100000000C000000000C0000000001
111111111111111111111111111111