1111111111111111111111
1P00000000000001111111
1000000C000000000000E1
1111111111111111111111