111111111111111111111111111111111111111111111
1P0000000000000C00000000000000000C00000000001
100111111111111111111111111111111000000000001
100000000C0000000000000C000000000000000000001
101111111111111111111111111111111111111111101
1000000000000C0000000000000C00000000000000001
101111111111111111111111111111111111111111101
10C0000000000000000C0000000000000C00000000001
100111111111111111111111111111111000000000001
100000000000C0000000000000C000000000000000001
101111111111111111111111111111111111111111101
1000000C0000000000000C00000000000000000000001
101111111111111111111111111111111111111111101
10000000000C0000000000000000C0000000000000001
100111111111111111111111111111111000000000001
1000000C0000000000000000C000000000000000000E1
101111111111111111111111111111111111111111101
100000000000000C000000000000C0000000000000001
101111111111111111111111111111111111111111101
10C00000000000000C000000000000000C00000000001
100111111111111111111111111111111000000000001
1000000000C00000000000C0000000000000000000001
100000000000000C00000000000C00000000000000001
100000000000000C00000000000C00000000000000001
100000000000000C00000000000C00000000000000001
100000000000000C00000000000C00000000000000001
111111111111111111111111111111111111111111111