11111111111111
100P0000000001
10000000000001
10000000000000
100000000000C1
100000000000E1
11111111111111